Bewildered - confused 
Bosom - chest 
Virtuous - of high morals 
Unflinching - no hesitation 
Arduous - strenuous, tiring 
Elusive - difficult to find 
Votary - someone who has made vows of dedication to a religious belief, strict follower 
Hypocrisy - claiming to have higher standards 
Deceive - deliberately make someone believe in something that is not true, fool someone 
Cowardice - lack of bravery 
Talisman - inscribed stone/ring believed to bring good luck 
Salvation - Source of saving one from harm or getting ruined 
Palate - Roof of mouth 
Indulgence - Act of involving oneself in some practice 
Renunciation - Formal rejection 
Ineffable - too great to be described in words 
Impunity - exemption from punishment 
Vindictive  - strong desire for revenge 
Lunacy - insanity (state of being lunatic)
Conundrum - a confusing and difficult problem
Cipher - cryptic representation
Insolence - rudeliness, overpowered 
Infallible - incapable of making mistakes 
Indelible - not removable 
Imploration - act of begging someone to do something 
Eloquence - fluency 
Liphomage - insincere devotion 
Communion - sharing of thoughts and intimate feelings
Bereft - Deprived if, lacking
Brazen - Bold and without shame 
Din - Prolonged, unpleasant and loud noise 
Naught - nothing 
Indweller - someone who's permanently present (in someone's soul)
Meekness - Submissiveness 
Vestige - a trace or remnant of something that is disappearing or no longer exists
Aught - Anything 
Stormtossed - Tossed by fierce winds
Baser - Without moral principles, ignoble (antonym of virtuous)
Tabernacle - a tent like dwelling 
Effulgence - shining brightly, radiant 
Feign - pretend to be affected by 
Anarchy - state of disorder in absence of just ruling authority 
Sceptic - a person who questions or doubts accepted opinion 
Fount - source of desirable quality 
Exultation - feeling of triumphant elation, rejoice 
Scaffold - a raised wooden platform